#####################
##.*******0******  ##
##.******* ******. ##
##******** *****.**##
##******** ****.***##
##******** ********##
##*****.** **.*****##
##                 ##
##*****.** **.*****##
##******** ********##
##***.**** ********##
##**.***** ********##
## .****** *******.##
##1 ****** *******.##
#####################
