#####################
##.               .##
##.               .##
##   ***     ***   ##
##  *****   *****  ##
## ******* ******* ##
##s**0 ***#*** 1**s##
## **b***#*****b** ##
##  ******#******  ##
##  *******#*****  ##
##   *****#*****   ##
##    ****#****    ##
##      *#***      ##
##.      *#*      .##
##        #        ##
##.               .##
#####################
