############
############
##.      .##
##        ##
##  #  #  ##
##fs0..1sf##
##  #  #  ##
##        ##
##.      .##
############
############
