###############################
#.     ****                  .#
#  0*****                     #
# *****                       #
# *   *** ***.****.**         #
# ** *** *************        #
# ***. **    *******       ***#
# *** ****************    ****#
# *.******.****.****   ** .***#
# * *** ************  *** ****#
#  ****   .*****  ****.   ****#
#  *****   ***********   ***.*#
#    ****    ******** 1* *****#
#    *****    *** *** ********#
#   ********.   **************#
# *****.****** ***********.***#
#.***************************.#
###############################
