
#####################
##0.** *** *** *** ##
## *** *** *** *** ##
## *** *** .** *** ##
## **.     *** *** ##
## *** *** *** .** ##
## *** *** *** *** ##
## *** *.*     *** ##
## *** *** *** ***1##
#####################